+++++++++++++++
+   +   ++ +  +
      +     +++
+ +    ++  ++++ 
+ +      +++  +
+      +  ++  + 
++ + +  +   + +
++++ ++      ++
+     + +  + ++
++ ++ ++    S +
+  ++    +++ ++
+++++++++++++++
